##### 
##  # 
# @$# 
##$ ##
## $ #
# $  #
#    #
#....#
######
