#####     
# @ #     
# $$#  ###
# $ #  #.#
 ## ####.#
 ##     .#
 #    #  #
 #    ####
 #########

