######   
#    #   
# $$$##  
#  #..###
##  ..$ #
## @    #
#########
