##############
#            #
#            #
#  #$#   .   #
#   $   # #  #
#@  $   .#.  #
#  ###  # #  #
#            #
#            #
##############
