    ######          
    ##   #          
    ##$  #          
  ####   ##         
  ##  $ $ #         
#### # ## #   ######
##   # ## #####   .#
## $             ..#
###### ### #@##   .#
    ##     #########
    ########        
